01d00068
01e04000
01d00065
01e04000
01d0006c
01e04000
01d0006c
01e04000
01d0006f
01e04000
01d00020
01e04000
01d00077
01e04000
01d0006f
01e04000
01d00072
01e04000
01d0006c
01e04000
01d00064
01e04000
01d00021
01e04000
01d0000a
01e04000
01dd001a
