01200068
01304000
01200065
01304000
0120006c
01304000
0120006c
01304000
0120006f
01304000
01200020
01304000
01200077
01304000
0120006f
01304000
01200072
01304000
0120006c
01304000
01200064
01304000
01200021
01304000
0120000a
01304000
012d001a
