01900068
01a04000
01900065
01a04000
0190006c
01a04000
0190006c
01a04000
0190006f
01a04000
01900020
01a04000
01900077
01a04000
0190006f
01a04000
01900072
01a04000
0190006c
01a04000
01900064
01a04000
01900021
01a04000
0190000a
01a04000
019d001a
